1111111111111111111111111
1000000000000000000000001
1000000000000000000000001
1000000000000000000000001
1000000010000000000000001
1000000010000000000000001
1000000010000000000000001
1000000010000000000000001
1000000000000000000010001
1000000000000000000010001
1000111111111110001111111
1000100000000001000000001
1000100000000000100000001
1000000000000000010000001
1000000000000000001000001
1000000000000000000001001
1000000000000000000010001
1111111111111111111111111