000000000000000000000000000000000000000000
000000000000000000000000000000000000000000
000000000000000000000000000000000000000000
000000000000000000000000000000000000000000
000000000000000000000000000000000000000000
000000001111110000000000000000000000000000
100000001000000000000031000000000000000001
100000001000000000003110000000001111444411
100000000000000000001100000000000000000001
100000000000000000001000003100000000000001
144411111111112000011111111000000000000311
100010000000001200000000000000000000003111
100010000000000120000000000000111000031111
100010000000000012000000000000000000311111
100010000000000001200000000000000000111111
100000000000000000000000000000000000000001
100000000000000000000310000000000000000001
100000000000000000000100000000011110500001
100000000000000000000000000000000000500001
111112000000000000000000000000000000500001
111111111111111111111111111111111111111111